011001100011111
100111011100111
011000101110011
110111101101100
110100101101111
101101101100101
011110011111011
101101101111110
110011101100001
001111010011110
010011011111110